Label	File
ACCU01_noMHC	~/Helena/sumstats/munged_noMHC/ACCU01_noMHC.sumstats.gz
ACHI01_noMHC	~/Helena/sumstats/munged_noMHC/ACHI01_noMHC.sumstats.gz
ADHD01_noMHC	~/Helena/sumstats/munged_noMHC/ADHD01_noMHC.sumstats.gz
ADHD02_noMHC	~/Helena/sumstats/munged_noMHC/ADHD02_noMHC.sumstats.gz
ADHD03_noMHC	~/Helena/sumstats/munged_noMHC/ADHD03_noMHC.sumstats.gz
ADHD04_noMHC	~/Helena/sumstats/munged_noMHC/ADHD04_noMHC.sumstats.gz
ADHD05_noMHC	~/Helena/sumstats/munged_noMHC/ADHD05_noMHC.sumstats.gz
ADHD05F_noMHC	~/Helena/sumstats/munged_noMHC/ADHD05F_noMHC.sumstats.gz
ADHD05M_noMHC	~/Helena/sumstats/munged_noMHC/ADHD05M_noMHC.sumstats.gz
ADIP01_noMHC	~/Helena/sumstats/munged_noMHC/ADIP01_noMHC.sumstats.gz
ADIP01F_noMHC	~/Helena/sumstats/munged_noMHC/ADIP01F_noMHC.sumstats.gz
ADIP01M_noMHC	~/Helena/sumstats/munged_noMHC/ADIP01M_noMHC.sumstats.gz
ADIP02_noMHC	~/Helena/sumstats/munged_noMHC/ADIP02_noMHC.sumstats.gz
ADIP02F_noMHC	~/Helena/sumstats/munged_noMHC/ADIP02F_noMHC.sumstats.gz
ADIP02M_noMHC	~/Helena/sumstats/munged_noMHC/ADIP02M_noMHC.sumstats.gz
ADIP03_noMHC	~/Helena/sumstats/munged_noMHC/ADIP03_noMHC.sumstats.gz
ADIP03F_noMHC	~/Helena/sumstats/munged_noMHC/ADIP03F_noMHC.sumstats.gz
ADIP03M_noMHC	~/Helena/sumstats/munged_noMHC/ADIP03M_noMHC.sumstats.gz
ADIP04_noMHC	~/Helena/sumstats/munged_noMHC/ADIP04_noMHC.sumstats.gz
ADIP04F_noMHC	~/Helena/sumstats/munged_noMHC/ADIP04F_noMHC.sumstats.gz
ADIP04M_noMHC	~/Helena/sumstats/munged_noMHC/ADIP04M_noMHC.sumstats.gz
ADIP05_noMHC	~/Helena/sumstats/munged_noMHC/ADIP05_noMHC.sumstats.gz
ADIP05F_noMHC	~/Helena/sumstats/munged_noMHC/ADIP05F_noMHC.sumstats.gz
ADIP05M_noMHC	~/Helena/sumstats/munged_noMHC/ADIP05M_noMHC.sumstats.gz
ADIP06_noMHC	~/Helena/sumstats/munged_noMHC/ADIP06_noMHC.sumstats.gz
ADIP06F_noMHC	~/Helena/sumstats/munged_noMHC/ADIP06F_noMHC.sumstats.gz
ADIP06M_noMHC	~/Helena/sumstats/munged_noMHC/ADIP06M_noMHC.sumstats.gz
ADIP07_noMHC	~/Helena/sumstats/munged_noMHC/ADIP07_noMHC.sumstats.gz
ADIP07F_noMHC	~/Helena/sumstats/munged_noMHC/ADIP07F_noMHC.sumstats.gz
ADIP07M_noMHC	~/Helena/sumstats/munged_noMHC/ADIP07M_noMHC.sumstats.gz
ADIP08_noMHC	~/Helena/sumstats/munged_noMHC/ADIP08_noMHC.sumstats.gz
ADIP08F_noMHC	~/Helena/sumstats/munged_noMHC/ADIP08F_noMHC.sumstats.gz
ADIP08M_noMHC	~/Helena/sumstats/munged_noMHC/ADIP08M_noMHC.sumstats.gz
ADIP09_noMHC	~/Helena/sumstats/munged_noMHC/ADIP09_noMHC.sumstats.gz
ADIP09F_noMHC	~/Helena/sumstats/munged_noMHC/ADIP09F_noMHC.sumstats.gz
ADIP09M_noMHC	~/Helena/sumstats/munged_noMHC/ADIP09M_noMHC.sumstats.gz
AGAB01_noMHC	~/Helena/sumstats/munged_noMHC/AGAB01_noMHC.sumstats.gz
AGGR01_noMHC	~/Helena/sumstats/munged_noMHC/AGGR01_noMHC.sumstats.gz
AGRA01_noMHC	~/Helena/sumstats/munged_noMHC/AGRA01_noMHC.sumstats.gz
ALCD01_noMHC	~/Helena/sumstats/munged_noMHC/ALCD01_noMHC.sumstats.gz
ALCD02_noMHC	~/Helena/sumstats/munged_noMHC/ALCD02_noMHC.sumstats.gz
ALCD03_noMHC	~/Helena/sumstats/munged_noMHC/ALCD03_noMHC.sumstats.gz
ALCD03F_noMHC	~/Helena/sumstats/munged_noMHC/ALCD03F_noMHC.sumstats.gz
ALCD03M_noMHC	~/Helena/sumstats/munged_noMHC/ALCD03M_noMHC.sumstats.gz
ALCO01_noMHC	~/Helena/sumstats/munged_noMHC/ALCO01_noMHC.sumstats.gz
ALCO01F_noMHC	~/Helena/sumstats/munged_noMHC/ALCO01F_noMHC.sumstats.gz
ALCO01M_noMHC	~/Helena/sumstats/munged_noMHC/ALCO01M_noMHC.sumstats.gz
ALCO02_noMHC	~/Helena/sumstats/munged_noMHC/ALCO02_noMHC.sumstats.gz
ALCO02F_noMHC	~/Helena/sumstats/munged_noMHC/ALCO02F_noMHC.sumstats.gz
ALCO02M_noMHC	~/Helena/sumstats/munged_noMHC/ALCO02M_noMHC.sumstats.gz
ALSD01_noMHC	~/Helena/sumstats/munged_noMHC/ALSD01_noMHC.sumstats.gz
ALSD01F_noMHC	~/Helena/sumstats/munged_noMHC/ALSD01F_noMHC.sumstats.gz
ALSD01M_noMHC	~/Helena/sumstats/munged_noMHC/ALSD01M_noMHC.sumstats.gz
ALZH01_noMHC	~/Helena/sumstats/munged_noMHC/ALZH01_noMHC.sumstats.gz
AMIN01_noMHC	~/Helena/sumstats/munged_noMHC/AMIN01_noMHC.sumstats.gz
AMIN02_noMHC	~/Helena/sumstats/munged_noMHC/AMIN02_noMHC.sumstats.gz
AMIN03_noMHC	~/Helena/sumstats/munged_noMHC/AMIN03_noMHC.sumstats.gz
AMIN04_noMHC	~/Helena/sumstats/munged_noMHC/AMIN04_noMHC.sumstats.gz
AMIN05_noMHC	~/Helena/sumstats/munged_noMHC/AMIN05_noMHC.sumstats.gz
AMIN06_noMHC	~/Helena/sumstats/munged_noMHC/AMIN06_noMHC.sumstats.gz
AMIN07_noMHC	~/Helena/sumstats/munged_noMHC/AMIN07_noMHC.sumstats.gz
AMIN08_noMHC	~/Helena/sumstats/munged_noMHC/AMIN08_noMHC.sumstats.gz
AMIN09_noMHC	~/Helena/sumstats/munged_noMHC/AMIN09_noMHC.sumstats.gz
AMYG01_noMHC	~/Helena/sumstats/munged_noMHC/AMYG01_noMHC.sumstats.gz
ANKL01_noMHC	~/Helena/sumstats/munged_noMHC/ANKL01_noMHC.sumstats.gz
ANKY01_noMHC	~/Helena/sumstats/munged_noMHC/ANKY01_noMHC.sumstats.gz
ANOR01_noMHC	~/Helena/sumstats/munged_noMHC/ANOR01_noMHC.sumstats.gz
ANOR02_noMHC	~/Helena/sumstats/munged_noMHC/ANOR02_noMHC.sumstats.gz
ANOR02F_noMHC	~/Helena/sumstats/munged_noMHC/ANOR02F_noMHC.sumstats.gz
ANOR02X_noMHC	~/Helena/sumstats/munged_noMHC/ANOR02X_noMHC.sumstats.gz
ANOR03_noMHC	~/Helena/sumstats/munged_noMHC/ANOR03_noMHC.sumstats.gz
ANOR04_noMHC	~/Helena/sumstats/munged_noMHC/ANOR04_noMHC.sumstats.gz
ANOR05_noMHC	~/Helena/sumstats/munged_noMHC/ANOR05_noMHC.sumstats.gz
ANOR06_noMHC	~/Helena/sumstats/munged_noMHC/ANOR06_noMHC.sumstats.gz
ANOR07_noMHC	~/Helena/sumstats/munged_noMHC/ANOR07_noMHC.sumstats.gz
ANXI01_noMHC	~/Helena/sumstats/munged_noMHC/ANXI01_noMHC.sumstats.gz
ANXI02_noMHC	~/Helena/sumstats/munged_noMHC/ANXI02_noMHC.sumstats.gz
ANXI03_noMHC	~/Helena/sumstats/munged_noMHC/ANXI03_noMHC.sumstats.gz
ANXI03F_noMHC	~/Helena/sumstats/munged_noMHC/ANXI03F_noMHC.sumstats.gz
ANXI03M_noMHC	~/Helena/sumstats/munged_noMHC/ANXI03M_noMHC.sumstats.gz
APOL01_noMHC	~/Helena/sumstats/munged_noMHC/APOL01_noMHC.sumstats.gz
APOL02_noMHC	~/Helena/sumstats/munged_noMHC/APOL02_noMHC.sumstats.gz
ASTH01_noMHC	~/Helena/sumstats/munged_noMHC/ASTH01_noMHC.sumstats.gz
ATOP01_noMHC	~/Helena/sumstats/munged_noMHC/ATOP01_noMHC.sumstats.gz
AUTI01_noMHC	~/Helena/sumstats/munged_noMHC/AUTI01_noMHC.sumstats.gz
AUTI02_noMHC	~/Helena/sumstats/munged_noMHC/AUTI02_noMHC.sumstats.gz
AUTI03_noMHC	~/Helena/sumstats/munged_noMHC/AUTI03_noMHC.sumstats.gz
AUTI04_noMHC	~/Helena/sumstats/munged_noMHC/AUTI04_noMHC.sumstats.gz
AUTI05_noMHC	~/Helena/sumstats/munged_noMHC/AUTI05_noMHC.sumstats.gz
AUTI06F_noMHC	~/Helena/sumstats/munged_noMHC/AUTI06F_noMHC.sumstats.gz
AUTI06M_noMHC	~/Helena/sumstats/munged_noMHC/AUTI06M_noMHC.sumstats.gz
BALD01_noMHC	~/Helena/sumstats/munged_noMHC/BALD01_noMHC.sumstats.gz
BFPC01_noMHC	~/Helena/sumstats/munged_noMHC/BFPC01_noMHC.sumstats.gz
BFPC02_noMHC	~/Helena/sumstats/munged_noMHC/BFPC02_noMHC.sumstats.gz
BFPC02B_noMHC	~/Helena/sumstats/munged_noMHC/BFPC02B_noMHC.sumstats.gz
BFPC02F_noMHC	~/Helena/sumstats/munged_noMHC/BFPC02F_noMHC.sumstats.gz
BFPC02M_noMHC	~/Helena/sumstats/munged_noMHC/BFPC02M_noMHC.sumstats.gz
BFPC03_noMHC	~/Helena/sumstats/munged_noMHC/BFPC03_noMHC.sumstats.gz
BFPC03B_noMHC	~/Helena/sumstats/munged_noMHC/BFPC03B_noMHC.sumstats.gz
BFPC03F_noMHC	~/Helena/sumstats/munged_noMHC/BFPC03F_noMHC.sumstats.gz
BFPC03M_noMHC	~/Helena/sumstats/munged_noMHC/BFPC03M_noMHC.sumstats.gz
BFPC04_noMHC	~/Helena/sumstats/munged_noMHC/BFPC04_noMHC.sumstats.gz
BFPC04B_noMHC	~/Helena/sumstats/munged_noMHC/BFPC04B_noMHC.sumstats.gz
BFPC04F_noMHC	~/Helena/sumstats/munged_noMHC/BFPC04F_noMHC.sumstats.gz
BFPC04M_noMHC	~/Helena/sumstats/munged_noMHC/BFPC04M_noMHC.sumstats.gz
BFPC05B_noMHC	~/Helena/sumstats/munged_noMHC/BFPC05B_noMHC.sumstats.gz
BIPO01_noMHC	~/Helena/sumstats/munged_noMHC/BIPO01_noMHC.sumstats.gz
BIPO02F_noMHC	~/Helena/sumstats/munged_noMHC/BIPO02F_noMHC.sumstats.gz
BIPO02M_noMHC	~/Helena/sumstats/munged_noMHC/BIPO02M_noMHC.sumstats.gz
BLOO01_noMHC	~/Helena/sumstats/munged_noMHC/BLOO01_noMHC.sumstats.gz
BLOO02_noMHC	~/Helena/sumstats/munged_noMHC/BLOO02_noMHC.sumstats.gz
BLOO03_noMHC	~/Helena/sumstats/munged_noMHC/BLOO03_noMHC.sumstats.gz
BLOO04_noMHC	~/Helena/sumstats/munged_noMHC/BLOO04_noMHC.sumstats.gz
BLOO05_noMHC	~/Helena/sumstats/munged_noMHC/BLOO05_noMHC.sumstats.gz
BLOO06_noMHC	~/Helena/sumstats/munged_noMHC/BLOO06_noMHC.sumstats.gz
BLOO07_noMHC	~/Helena/sumstats/munged_noMHC/BLOO07_noMHC.sumstats.gz
BLOO08_noMHC	~/Helena/sumstats/munged_noMHC/BLOO08_noMHC.sumstats.gz
BLOO09_noMHC	~/Helena/sumstats/munged_noMHC/BLOO09_noMHC.sumstats.gz
BLOO10_noMHC	~/Helena/sumstats/munged_noMHC/BLOO10_noMHC.sumstats.gz
BLOO11_noMHC	~/Helena/sumstats/munged_noMHC/BLOO11_noMHC.sumstats.gz
BLOO12_noMHC	~/Helena/sumstats/munged_noMHC/BLOO12_noMHC.sumstats.gz
BLOO13_noMHC	~/Helena/sumstats/munged_noMHC/BLOO13_noMHC.sumstats.gz
BLOO14_noMHC	~/Helena/sumstats/munged_noMHC/BLOO14_noMHC.sumstats.gz
BLOO15_noMHC	~/Helena/sumstats/munged_noMHC/BLOO15_noMHC.sumstats.gz
BLOO16_noMHC	~/Helena/sumstats/munged_noMHC/BLOO16_noMHC.sumstats.gz
BLOO17_noMHC	~/Helena/sumstats/munged_noMHC/BLOO17_noMHC.sumstats.gz
BLOO18_noMHC	~/Helena/sumstats/munged_noMHC/BLOO18_noMHC.sumstats.gz
BLOO19_noMHC	~/Helena/sumstats/munged_noMHC/BLOO19_noMHC.sumstats.gz
BLOO20_noMHC	~/Helena/sumstats/munged_noMHC/BLOO20_noMHC.sumstats.gz
BLOO21_noMHC	~/Helena/sumstats/munged_noMHC/BLOO21_noMHC.sumstats.gz
BLOO22_noMHC	~/Helena/sumstats/munged_noMHC/BLOO22_noMHC.sumstats.gz
BLOO23_noMHC	~/Helena/sumstats/munged_noMHC/BLOO23_noMHC.sumstats.gz
BLOO24_noMHC	~/Helena/sumstats/munged_noMHC/BLOO24_noMHC.sumstats.gz
BLOO25_noMHC	~/Helena/sumstats/munged_noMHC/BLOO25_noMHC.sumstats.gz
BLOO26_noMHC	~/Helena/sumstats/munged_noMHC/BLOO26_noMHC.sumstats.gz
BLOO27_noMHC	~/Helena/sumstats/munged_noMHC/BLOO27_noMHC.sumstats.gz
BLOO28_noMHC	~/Helena/sumstats/munged_noMHC/BLOO28_noMHC.sumstats.gz
BLOO29_noMHC	~/Helena/sumstats/munged_noMHC/BLOO29_noMHC.sumstats.gz
BLOO30_noMHC	~/Helena/sumstats/munged_noMHC/BLOO30_noMHC.sumstats.gz
BLOO31_noMHC	~/Helena/sumstats/munged_noMHC/BLOO31_noMHC.sumstats.gz
BLOO32_noMHC	~/Helena/sumstats/munged_noMHC/BLOO32_noMHC.sumstats.gz
BLOO33_noMHC	~/Helena/sumstats/munged_noMHC/BLOO33_noMHC.sumstats.gz
BLOO34_noMHC	~/Helena/sumstats/munged_noMHC/BLOO34_noMHC.sumstats.gz
BLOO35_noMHC	~/Helena/sumstats/munged_noMHC/BLOO35_noMHC.sumstats.gz
BLOO36_noMHC	~/Helena/sumstats/munged_noMHC/BLOO36_noMHC.sumstats.gz
BODY02_noMHC	~/Helena/sumstats/munged_noMHC/BODY02_noMHC.sumstats.gz
BODY03_noMHC	~/Helena/sumstats/munged_noMHC/BODY03_noMHC.sumstats.gz
BODY04_noMHC	~/Helena/sumstats/munged_noMHC/BODY04_noMHC.sumstats.gz
BODY04F_noMHC	~/Helena/sumstats/munged_noMHC/BODY04F_noMHC.sumstats.gz
BODY04M_noMHC	~/Helena/sumstats/munged_noMHC/BODY04M_noMHC.sumstats.gz
BODY05_noMHC	~/Helena/sumstats/munged_noMHC/BODY05_noMHC.sumstats.gz
BODY06_noMHC	~/Helena/sumstats/munged_noMHC/BODY06_noMHC.sumstats.gz
BODY06B_noMHC	~/Helena/sumstats/munged_noMHC/BODY06B_noMHC.sumstats.gz
BODY06F_noMHC	~/Helena/sumstats/munged_noMHC/BODY06F_noMHC.sumstats.gz
BODY06M_noMHC	~/Helena/sumstats/munged_noMHC/BODY06M_noMHC.sumstats.gz
BODY07_noMHC	~/Helena/sumstats/munged_noMHC/BODY07_noMHC.sumstats.gz
BODY07B_noMHC	~/Helena/sumstats/munged_noMHC/BODY07B_noMHC.sumstats.gz
BODY07F_noMHC	~/Helena/sumstats/munged_noMHC/BODY07F_noMHC.sumstats.gz
BODY07M_noMHC	~/Helena/sumstats/munged_noMHC/BODY07M_noMHC.sumstats.gz
BODY08_noMHC	~/Helena/sumstats/munged_noMHC/BODY08_noMHC.sumstats.gz
BODY08B_noMHC	~/Helena/sumstats/munged_noMHC/BODY08B_noMHC.sumstats.gz
BODY08F_noMHC	~/Helena/sumstats/munged_noMHC/BODY08F_noMHC.sumstats.gz
BODY08M_noMHC	~/Helena/sumstats/munged_noMHC/BODY08M_noMHC.sumstats.gz
BODY09_noMHC	~/Helena/sumstats/munged_noMHC/BODY09_noMHC.sumstats.gz
BODY10_noMHC	~/Helena/sumstats/munged_noMHC/BODY10_noMHC.sumstats.gz
BODY11_noMHC	~/Helena/sumstats/munged_noMHC/BODY11_noMHC.sumstats.gz
BODY12_noMHC	~/Helena/sumstats/munged_noMHC/BODY12_noMHC.sumstats.gz
BODY12F_noMHC	~/Helena/sumstats/munged_noMHC/BODY12F_noMHC.sumstats.gz
BODY12M_noMHC	~/Helena/sumstats/munged_noMHC/BODY12M_noMHC.sumstats.gz
BODY13B_noMHC	~/Helena/sumstats/munged_noMHC/BODY13B_noMHC.sumstats.gz
BORD01_noMHC	~/Helena/sumstats/munged_noMHC/BORD01_noMHC.sumstats.gz
CANU01_noMHC	~/Helena/sumstats/munged_noMHC/CANU01_noMHC.sumstats.gz
CAUD01_noMHC	~/Helena/sumstats/munged_noMHC/CAUD01_noMHC.sumstats.gz
CELI01_noMHC	~/Helena/sumstats/munged_noMHC/CELI01_noMHC.sumstats.gz
CHKD01_noMHC	~/Helena/sumstats/munged_noMHC/CHKD01_noMHC.sumstats.gz
CHOL01_noMHC	~/Helena/sumstats/munged_noMHC/CHOL01_noMHC.sumstats.gz
CHOL02_noMHC	~/Helena/sumstats/munged_noMHC/CHOL02_noMHC.sumstats.gz
CHOL03_noMHC	~/Helena/sumstats/munged_noMHC/CHOL03_noMHC.sumstats.gz
CHOL04_noMHC	~/Helena/sumstats/munged_noMHC/CHOL04_noMHC.sumstats.gz
CHOL05_noMHC	~/Helena/sumstats/munged_noMHC/CHOL05_noMHC.sumstats.gz
CHOL06_noMHC	~/Helena/sumstats/munged_noMHC/CHOL06_noMHC.sumstats.gz
CHOL07_noMHC	~/Helena/sumstats/munged_noMHC/CHOL07_noMHC.sumstats.gz
CHOL08_noMHC	~/Helena/sumstats/munged_noMHC/CHOL08_noMHC.sumstats.gz
CHOL09_noMHC	~/Helena/sumstats/munged_noMHC/CHOL09_noMHC.sumstats.gz
CHOL10_noMHC	~/Helena/sumstats/munged_noMHC/CHOL10_noMHC.sumstats.gz
CHOL11_noMHC	~/Helena/sumstats/munged_noMHC/CHOL11_noMHC.sumstats.gz
CHOL12_noMHC	~/Helena/sumstats/munged_noMHC/CHOL12_noMHC.sumstats.gz
CHOL13_noMHC	~/Helena/sumstats/munged_noMHC/CHOL13_noMHC.sumstats.gz
CHOL14_noMHC	~/Helena/sumstats/munged_noMHC/CHOL14_noMHC.sumstats.gz
CHOL15_noMHC	~/Helena/sumstats/munged_noMHC/CHOL15_noMHC.sumstats.gz
CHOL16_noMHC	~/Helena/sumstats/munged_noMHC/CHOL16_noMHC.sumstats.gz
CHOL17_noMHC	~/Helena/sumstats/munged_noMHC/CHOL17_noMHC.sumstats.gz
CHOL18_noMHC	~/Helena/sumstats/munged_noMHC/CHOL18_noMHC.sumstats.gz
CHOL19_noMHC	~/Helena/sumstats/munged_noMHC/CHOL19_noMHC.sumstats.gz
CHOL20_noMHC	~/Helena/sumstats/munged_noMHC/CHOL20_noMHC.sumstats.gz
CHOL21_noMHC	~/Helena/sumstats/munged_noMHC/CHOL21_noMHC.sumstats.gz
CHOL22_noMHC	~/Helena/sumstats/munged_noMHC/CHOL22_noMHC.sumstats.gz
CHOL23_noMHC	~/Helena/sumstats/munged_noMHC/CHOL23_noMHC.sumstats.gz
CHOL24_noMHC	~/Helena/sumstats/munged_noMHC/CHOL24_noMHC.sumstats.gz
CHOL25_noMHC	~/Helena/sumstats/munged_noMHC/CHOL25_noMHC.sumstats.gz
CHOL26_noMHC	~/Helena/sumstats/munged_noMHC/CHOL26_noMHC.sumstats.gz
CHOL27_noMHC	~/Helena/sumstats/munged_noMHC/CHOL27_noMHC.sumstats.gz
CHOL28_noMHC	~/Helena/sumstats/munged_noMHC/CHOL28_noMHC.sumstats.gz
CHOL29_noMHC	~/Helena/sumstats/munged_noMHC/CHOL29_noMHC.sumstats.gz
CHOL30_noMHC	~/Helena/sumstats/munged_noMHC/CHOL30_noMHC.sumstats.gz
CHOL31_noMHC	~/Helena/sumstats/munged_noMHC/CHOL31_noMHC.sumstats.gz
CHOL32_noMHC	~/Helena/sumstats/munged_noMHC/CHOL32_noMHC.sumstats.gz
CHOL33_noMHC	~/Helena/sumstats/munged_noMHC/CHOL33_noMHC.sumstats.gz
CHOL34_noMHC	~/Helena/sumstats/munged_noMHC/CHOL34_noMHC.sumstats.gz
CHRO01_noMHC	~/Helena/sumstats/munged_noMHC/CHRO01_noMHC.sumstats.gz
CHRO02_noMHC	~/Helena/sumstats/munged_noMHC/CHRO02_noMHC.sumstats.gz
CHRO05_noMHC	~/Helena/sumstats/munged_noMHC/CHRO05_noMHC.sumstats.gz
CHRO06_noMHC	~/Helena/sumstats/munged_noMHC/CHRO06_noMHC.sumstats.gz
CHRR06_noMHC	~/Helena/sumstats/munged_noMHC/CHRR06_noMHC.sumstats.gz
CHRR13_noMHC	~/Helena/sumstats/munged_noMHC/CHRR13_noMHC.sumstats.gz
CIRR01_noMHC	~/Helena/sumstats/munged_noMHC/CIRR01_noMHC.sumstats.gz
COAD01_noMHC	~/Helena/sumstats/munged_noMHC/COAD01_noMHC.sumstats.gz
COAD02_noMHC	~/Helena/sumstats/munged_noMHC/COAD02_noMHC.sumstats.gz
COAD03_noMHC	~/Helena/sumstats/munged_noMHC/COAD03_noMHC.sumstats.gz
COGN01_noMHC	~/Helena/sumstats/munged_noMHC/COGN01_noMHC.sumstats.gz
COLL01_noMHC	~/Helena/sumstats/munged_noMHC/COLL01_noMHC.sumstats.gz
CONS01_noMHC	~/Helena/sumstats/munged_noMHC/CONS01_noMHC.sumstats.gz
COTI01_noMHC	~/Helena/sumstats/munged_noMHC/COTI01_noMHC.sumstats.gz
CROH01_noMHC	~/Helena/sumstats/munged_noMHC/CROH01_noMHC.sumstats.gz
CROS01_noMHC	~/Helena/sumstats/munged_noMHC/CROS01_noMHC.sumstats.gz
CRPR01_noMHC	~/Helena/sumstats/munged_noMHC/CRPR01_noMHC.sumstats.gz
DEPR01_noMHC	~/Helena/sumstats/munged_noMHC/DEPR01_noMHC.sumstats.gz
DEPR02_noMHC	~/Helena/sumstats/munged_noMHC/DEPR02_noMHC.sumstats.gz
DEPR03_noMHC	~/Helena/sumstats/munged_noMHC/DEPR03_noMHC.sumstats.gz
DEPR03F_noMHC	~/Helena/sumstats/munged_noMHC/DEPR03F_noMHC.sumstats.gz
DEPR03M_noMHC	~/Helena/sumstats/munged_noMHC/DEPR03M_noMHC.sumstats.gz
DEPR05_noMHC	~/Helena/sumstats/munged_noMHC/DEPR05_noMHC.sumstats.gz
DEPR05F_noMHC	~/Helena/sumstats/munged_noMHC/DEPR05F_noMHC.sumstats.gz
DEPR05M_noMHC	~/Helena/sumstats/munged_noMHC/DEPR05M_noMHC.sumstats.gz
DEPR07_noMHC	~/Helena/sumstats/munged_noMHC/DEPR07_noMHC.sumstats.gz
DIAB02_noMHC	~/Helena/sumstats/munged_noMHC/DIAB02_noMHC.sumstats.gz
DIAB03_noMHC	~/Helena/sumstats/munged_noMHC/DIAB03_noMHC.sumstats.gz
DIAB05_noMHC	~/Helena/sumstats/munged_noMHC/DIAB05_noMHC.sumstats.gz
DIAB06_noMHC	~/Helena/sumstats/munged_noMHC/DIAB06_noMHC.sumstats.gz
DIAB07_noMHC	~/Helena/sumstats/munged_noMHC/DIAB07_noMHC.sumstats.gz
DIAR01_noMHC	~/Helena/sumstats/munged_noMHC/DIAR01_noMHC.sumstats.gz
DIAR02_noMHC	~/Helena/sumstats/munged_noMHC/DIAR02_noMHC.sumstats.gz
DIAR03_noMHC	~/Helena/sumstats/munged_noMHC/DIAR03_noMHC.sumstats.gz
DIAR04_noMHC	~/Helena/sumstats/munged_noMHC/DIAR04_noMHC.sumstats.gz
EDUC01_noMHC	~/Helena/sumstats/munged_noMHC/EDUC01_noMHC.sumstats.gz
EDUC01F_noMHC	~/Helena/sumstats/munged_noMHC/EDUC01F_noMHC.sumstats.gz
EDUC01M_noMHC	~/Helena/sumstats/munged_noMHC/EDUC01M_noMHC.sumstats.gz
EDUC02_noMHC	~/Helena/sumstats/munged_noMHC/EDUC02_noMHC.sumstats.gz
EDUC03_noMHC	~/Helena/sumstats/munged_noMHC/EDUC03_noMHC.sumstats.gz
ELEC01_noMHC	~/Helena/sumstats/munged_noMHC/ELEC01_noMHC.sumstats.gz
ELEC02_noMHC	~/Helena/sumstats/munged_noMHC/ELEC02_noMHC.sumstats.gz
ELEC03_noMHC	~/Helena/sumstats/munged_noMHC/ELEC03_noMHC.sumstats.gz
ELEC04_noMHC	~/Helena/sumstats/munged_noMHC/ELEC04_noMHC.sumstats.gz
EPIL01_noMHC	~/Helena/sumstats/munged_noMHC/EPIL01_noMHC.sumstats.gz
EXTR01_noMHC	~/Helena/sumstats/munged_noMHC/EXTR01_noMHC.sumstats.gz
EYEC01_noMHC	~/Helena/sumstats/munged_noMHC/EYEC01_noMHC.sumstats.gz
EYEC01F_noMHC	~/Helena/sumstats/munged_noMHC/EYEC01F_noMHC.sumstats.gz
EYEC01M_noMHC	~/Helena/sumstats/munged_noMHC/EYEC01M_noMHC.sumstats.gz
EYEC02_noMHC	~/Helena/sumstats/munged_noMHC/EYEC02_noMHC.sumstats.gz
EYEC02F_noMHC	~/Helena/sumstats/munged_noMHC/EYEC02F_noMHC.sumstats.gz
EYEC02M_noMHC	~/Helena/sumstats/munged_noMHC/EYEC02M_noMHC.sumstats.gz
EYEC03_noMHC	~/Helena/sumstats/munged_noMHC/EYEC03_noMHC.sumstats.gz
EYEC03F_noMHC	~/Helena/sumstats/munged_noMHC/EYEC03F_noMHC.sumstats.gz
EYEC03M_noMHC	~/Helena/sumstats/munged_noMHC/EYEC03M_noMHC.sumstats.gz
FATM02_noMHC	~/Helena/sumstats/munged_noMHC/FATM02_noMHC.sumstats.gz
FATM02B_noMHC	~/Helena/sumstats/munged_noMHC/FATM02B_noMHC.sumstats.gz
FATM02F_noMHC	~/Helena/sumstats/munged_noMHC/FATM02F_noMHC.sumstats.gz
FATM02M_noMHC	~/Helena/sumstats/munged_noMHC/FATM02M_noMHC.sumstats.gz
FATM03_noMHC	~/Helena/sumstats/munged_noMHC/FATM03_noMHC.sumstats.gz
FATM03B_noMHC	~/Helena/sumstats/munged_noMHC/FATM03B_noMHC.sumstats.gz
FATM03F_noMHC	~/Helena/sumstats/munged_noMHC/FATM03F_noMHC.sumstats.gz
FATM03M_noMHC	~/Helena/sumstats/munged_noMHC/FATM03M_noMHC.sumstats.gz
FATM04_noMHC	~/Helena/sumstats/munged_noMHC/FATM04_noMHC.sumstats.gz
FATM04B_noMHC	~/Helena/sumstats/munged_noMHC/FATM04B_noMHC.sumstats.gz
FATM04F_noMHC	~/Helena/sumstats/munged_noMHC/FATM04F_noMHC.sumstats.gz
FATM04M_noMHC	~/Helena/sumstats/munged_noMHC/FATM04M_noMHC.sumstats.gz
FATM05B_noMHC	~/Helena/sumstats/munged_noMHC/FATM05B_noMHC.sumstats.gz
FATT04_noMHC	~/Helena/sumstats/munged_noMHC/FATT04_noMHC.sumstats.gz
FATT06_noMHC	~/Helena/sumstats/munged_noMHC/FATT06_noMHC.sumstats.gz
FATT07_noMHC	~/Helena/sumstats/munged_noMHC/FATT07_noMHC.sumstats.gz
FATT10_noMHC	~/Helena/sumstats/munged_noMHC/FATT10_noMHC.sumstats.gz
FATT13_noMHC	~/Helena/sumstats/munged_noMHC/FATT13_noMHC.sumstats.gz
FATT15_noMHC	~/Helena/sumstats/munged_noMHC/FATT15_noMHC.sumstats.gz
FATT18_noMHC	~/Helena/sumstats/munged_noMHC/FATT18_noMHC.sumstats.gz
FATT20_noMHC	~/Helena/sumstats/munged_noMHC/FATT20_noMHC.sumstats.gz
FATT21_noMHC	~/Helena/sumstats/munged_noMHC/FATT21_noMHC.sumstats.gz
FATT22_noMHC	~/Helena/sumstats/munged_noMHC/FATT22_noMHC.sumstats.gz
FATT24_noMHC	~/Helena/sumstats/munged_noMHC/FATT24_noMHC.sumstats.gz
FATT25_noMHC	~/Helena/sumstats/munged_noMHC/FATT25_noMHC.sumstats.gz
FATT26_noMHC	~/Helena/sumstats/munged_noMHC/FATT26_noMHC.sumstats.gz
FATT29_noMHC	~/Helena/sumstats/munged_noMHC/FATT29_noMHC.sumstats.gz
FATT31_noMHC	~/Helena/sumstats/munged_noMHC/FATT31_noMHC.sumstats.gz
FOOD01F_noMHC	~/Helena/sumstats/munged_noMHC/FOOD01F_noMHC.sumstats.gz
GAIT01_noMHC	~/Helena/sumstats/munged_noMHC/GAIT01_noMHC.sumstats.gz
GLAU01_noMHC	~/Helena/sumstats/munged_noMHC/GLAU01_noMHC.sumstats.gz
GLYC01_noMHC	~/Helena/sumstats/munged_noMHC/GLYC01_noMHC.sumstats.gz
GLYC02_noMHC	~/Helena/sumstats/munged_noMHC/GLYC02_noMHC.sumstats.gz
GLYC03_noMHC	~/Helena/sumstats/munged_noMHC/GLYC03_noMHC.sumstats.gz
GLYC04_noMHC	~/Helena/sumstats/munged_noMHC/GLYC04_noMHC.sumstats.gz
GLYC05_noMHC	~/Helena/sumstats/munged_noMHC/GLYC05_noMHC.sumstats.gz
GLYC06_noMHC	~/Helena/sumstats/munged_noMHC/GLYC06_noMHC.sumstats.gz
GLYC07_noMHC	~/Helena/sumstats/munged_noMHC/GLYC07_noMHC.sumstats.gz
GLYC08_noMHC	~/Helena/sumstats/munged_noMHC/GLYC08_noMHC.sumstats.gz
GLYC09_noMHC	~/Helena/sumstats/munged_noMHC/GLYC09_noMHC.sumstats.gz
GLYC10_noMHC	~/Helena/sumstats/munged_noMHC/GLYC10_noMHC.sumstats.gz
GLYC11_noMHC	~/Helena/sumstats/munged_noMHC/GLYC11_noMHC.sumstats.gz
GLYC12_noMHC	~/Helena/sumstats/munged_noMHC/GLYC12_noMHC.sumstats.gz
GLYC13_noMHC	~/Helena/sumstats/munged_noMHC/GLYC13_noMHC.sumstats.gz
GLYC14_noMHC	~/Helena/sumstats/munged_noMHC/GLYC14_noMHC.sumstats.gz
GLYC15_noMHC	~/Helena/sumstats/munged_noMHC/GLYC15_noMHC.sumstats.gz
GLYC16_noMHC	~/Helena/sumstats/munged_noMHC/GLYC16_noMHC.sumstats.gz
GLYC16F_noMHC	~/Helena/sumstats/munged_noMHC/GLYC16F_noMHC.sumstats.gz
GLYC16M_noMHC	~/Helena/sumstats/munged_noMHC/GLYC16M_noMHC.sumstats.gz
GLYC17_noMHC	~/Helena/sumstats/munged_noMHC/GLYC17_noMHC.sumstats.gz
GLYC17F_noMHC	~/Helena/sumstats/munged_noMHC/GLYC17F_noMHC.sumstats.gz
GLYC17M_noMHC	~/Helena/sumstats/munged_noMHC/GLYC17M_noMHC.sumstats.gz
GLYC18_noMHC	~/Helena/sumstats/munged_noMHC/GLYC18_noMHC.sumstats.gz
GLYC18F_noMHC	~/Helena/sumstats/munged_noMHC/GLYC18F_noMHC.sumstats.gz
GLYC18M_noMHC	~/Helena/sumstats/munged_noMHC/GLYC18M_noMHC.sumstats.gz
GLYC19_noMHC	~/Helena/sumstats/munged_noMHC/GLYC19_noMHC.sumstats.gz
GLYC19F_noMHC	~/Helena/sumstats/munged_noMHC/GLYC19F_noMHC.sumstats.gz
GLYC19M_noMHC	~/Helena/sumstats/munged_noMHC/GLYC19M_noMHC.sumstats.gz
GLYC22_noMHC	~/Helena/sumstats/munged_noMHC/GLYC22_noMHC.sumstats.gz
GLYC24_noMHC	~/Helena/sumstats/munged_noMHC/GLYC24_noMHC.sumstats.gz
GLYC25_noMHC	~/Helena/sumstats/munged_noMHC/GLYC25_noMHC.sumstats.gz
GLYC26_noMHC	~/Helena/sumstats/munged_noMHC/GLYC26_noMHC.sumstats.gz
GLYC27_noMHC	~/Helena/sumstats/munged_noMHC/GLYC27_noMHC.sumstats.gz
GLYC28_noMHC	~/Helena/sumstats/munged_noMHC/GLYC28_noMHC.sumstats.gz
GLYC29_noMHC	~/Helena/sumstats/munged_noMHC/GLYC29_noMHC.sumstats.gz
GLYC30_noMHC	~/Helena/sumstats/munged_noMHC/GLYC30_noMHC.sumstats.gz
GLYC31_noMHC	~/Helena/sumstats/munged_noMHC/GLYC31_noMHC.sumstats.gz
GLYC32_noMHC	~/Helena/sumstats/munged_noMHC/GLYC32_noMHC.sumstats.gz
GLYC33_noMHC	~/Helena/sumstats/munged_noMHC/GLYC33_noMHC.sumstats.gz
GLYC34_noMHC	~/Helena/sumstats/munged_noMHC/GLYC34_noMHC.sumstats.gz
GLYC35_noMHC	~/Helena/sumstats/munged_noMHC/GLYC35_noMHC.sumstats.gz
GLYC36_noMHC	~/Helena/sumstats/munged_noMHC/GLYC36_noMHC.sumstats.gz
GLYC37_noMHC	~/Helena/sumstats/munged_noMHC/GLYC37_noMHC.sumstats.gz
GLYC38_noMHC	~/Helena/sumstats/munged_noMHC/GLYC38_noMHC.sumstats.gz
GLYC39_noMHC	~/Helena/sumstats/munged_noMHC/GLYC39_noMHC.sumstats.gz
GLYC40_noMHC	~/Helena/sumstats/munged_noMHC/GLYC40_noMHC.sumstats.gz
GLYC41_noMHC	~/Helena/sumstats/munged_noMHC/GLYC41_noMHC.sumstats.gz
GLYC42_noMHC	~/Helena/sumstats/munged_noMHC/GLYC42_noMHC.sumstats.gz
GLYC43_noMHC	~/Helena/sumstats/munged_noMHC/GLYC43_noMHC.sumstats.gz
GLYC44_noMHC	~/Helena/sumstats/munged_noMHC/GLYC44_noMHC.sumstats.gz
GLYC45_noMHC	~/Helena/sumstats/munged_noMHC/GLYC45_noMHC.sumstats.gz
GLYC46_noMHC	~/Helena/sumstats/munged_noMHC/GLYC46_noMHC.sumstats.gz
GOUT01_noMHC	~/Helena/sumstats/munged_noMHC/GOUT01_noMHC.sumstats.gz
GROW01_noMHC	~/Helena/sumstats/munged_noMHC/GROW01_noMHC.sumstats.gz
GROW01F_noMHC	~/Helena/sumstats/munged_noMHC/GROW01F_noMHC.sumstats.gz
GROW01M_noMHC	~/Helena/sumstats/munged_noMHC/GROW01M_noMHC.sumstats.gz
GROW02_noMHC	~/Helena/sumstats/munged_noMHC/GROW02_noMHC.sumstats.gz
GROW02F_noMHC	~/Helena/sumstats/munged_noMHC/GROW02F_noMHC.sumstats.gz
GROW02M_noMHC	~/Helena/sumstats/munged_noMHC/GROW02M_noMHC.sumstats.gz
GROW03_noMHC	~/Helena/sumstats/munged_noMHC/GROW03_noMHC.sumstats.gz
GROW03F_noMHC	~/Helena/sumstats/munged_noMHC/GROW03F_noMHC.sumstats.gz
GROW03M_noMHC	~/Helena/sumstats/munged_noMHC/GROW03M_noMHC.sumstats.gz
HEAD01_noMHC	~/Helena/sumstats/munged_noMHC/HEAD01_noMHC.sumstats.gz
HEAL01_noMHC	~/Helena/sumstats/munged_noMHC/HEAL01_noMHC.sumstats.gz
HEAR01_noMHC	~/Helena/sumstats/munged_noMHC/HEAR01_noMHC.sumstats.gz
HEIG01_noMHC	~/Helena/sumstats/munged_noMHC/HEIG01_noMHC.sumstats.gz
HEIG02_noMHC	~/Helena/sumstats/munged_noMHC/HEIG02_noMHC.sumstats.gz
HEIG03_noMHC	~/Helena/sumstats/munged_noMHC/HEIG03_noMHC.sumstats.gz
HEIG04F_noMHC	~/Helena/sumstats/munged_noMHC/HEIG04F_noMHC.sumstats.gz
HEIG04M_noMHC	~/Helena/sumstats/munged_noMHC/HEIG04M_noMHC.sumstats.gz
HEIG07_noMHC	~/Helena/sumstats/munged_noMHC/HEIG07_noMHC.sumstats.gz
HEIG07F_noMHC	~/Helena/sumstats/munged_noMHC/HEIG07F_noMHC.sumstats.gz
HEIG07M_noMHC	~/Helena/sumstats/munged_noMHC/HEIG07M_noMHC.sumstats.gz
HIPC01_noMHC	~/Helena/sumstats/munged_noMHC/HIPC01_noMHC.sumstats.gz
HIPC01F_noMHC	~/Helena/sumstats/munged_noMHC/HIPC01F_noMHC.sumstats.gz
HIPC01M_noMHC	~/Helena/sumstats/munged_noMHC/HIPC01M_noMHC.sumstats.gz
HIPC02_noMHC	~/Helena/sumstats/munged_noMHC/HIPC02_noMHC.sumstats.gz
HIPC02F_noMHC	~/Helena/sumstats/munged_noMHC/HIPC02F_noMHC.sumstats.gz
HIPC02M_noMHC	~/Helena/sumstats/munged_noMHC/HIPC02M_noMHC.sumstats.gz
HIPC03_noMHC	~/Helena/sumstats/munged_noMHC/HIPC03_noMHC.sumstats.gz
HIPC03F_noMHC	~/Helena/sumstats/munged_noMHC/HIPC03F_noMHC.sumstats.gz
HIPC03M_noMHC	~/Helena/sumstats/munged_noMHC/HIPC03M_noMHC.sumstats.gz
HIPC04_noMHC	~/Helena/sumstats/munged_noMHC/HIPC04_noMHC.sumstats.gz
HIPC04F_noMHC	~/Helena/sumstats/munged_noMHC/HIPC04F_noMHC.sumstats.gz
HIPC04M_noMHC	~/Helena/sumstats/munged_noMHC/HIPC04M_noMHC.sumstats.gz
HIPP01_noMHC	~/Helena/sumstats/munged_noMHC/HIPP01_noMHC.sumstats.gz
ICVO01_noMHC	~/Helena/sumstats/munged_noMHC/ICVO01_noMHC.sumstats.gz
INCO01_noMHC	~/Helena/sumstats/munged_noMHC/INCO01_noMHC.sumstats.gz
INCO02_noMHC	~/Helena/sumstats/munged_noMHC/INCO02_noMHC.sumstats.gz
INCO03_noMHC	~/Helena/sumstats/munged_noMHC/INCO03_noMHC.sumstats.gz
INFB01_noMHC	~/Helena/sumstats/munged_noMHC/INFB01_noMHC.sumstats.gz
INFL01_noMHC	~/Helena/sumstats/munged_noMHC/INFL01_noMHC.sumstats.gz
INSO01_noMHC	~/Helena/sumstats/munged_noMHC/INSO01_noMHC.sumstats.gz
INSO01F_noMHC	~/Helena/sumstats/munged_noMHC/INSO01F_noMHC.sumstats.gz
INSO01M_noMHC	~/Helena/sumstats/munged_noMHC/INSO01M_noMHC.sumstats.gz
INTE01_noMHC	~/Helena/sumstats/munged_noMHC/INTE01_noMHC.sumstats.gz
INTE02_noMHC	~/Helena/sumstats/munged_noMHC/INTE02_noMHC.sumstats.gz
INTE03_noMHC	~/Helena/sumstats/munged_noMHC/INTE03_noMHC.sumstats.gz
INTZ01_noMHC	~/Helena/sumstats/munged_noMHC/INTZ01_noMHC.sumstats.gz
IRON01_noMHC	~/Helena/sumstats/munged_noMHC/IRON01_noMHC.sumstats.gz
IRON02_noMHC	~/Helena/sumstats/munged_noMHC/IRON02_noMHC.sumstats.gz
IRON03_noMHC	~/Helena/sumstats/munged_noMHC/IRON03_noMHC.sumstats.gz
KETO01_noMHC	~/Helena/sumstats/munged_noMHC/KETO01_noMHC.sumstats.gz
KETO02_noMHC	~/Helena/sumstats/munged_noMHC/KETO02_noMHC.sumstats.gz
KETO03_noMHC	~/Helena/sumstats/munged_noMHC/KETO03_noMHC.sumstats.gz
LEAN01_noMHC	~/Helena/sumstats/munged_noMHC/LEAN01_noMHC.sumstats.gz
LEAN02_noMHC	~/Helena/sumstats/munged_noMHC/LEAN02_noMHC.sumstats.gz
LEAN03_noMHC	~/Helena/sumstats/munged_noMHC/LEAN03_noMHC.sumstats.gz
LEAN04_noMHC	~/Helena/sumstats/munged_noMHC/LEAN04_noMHC.sumstats.gz
LEAN04B_noMHC	~/Helena/sumstats/munged_noMHC/LEAN04B_noMHC.sumstats.gz
LEAN04F_noMHC	~/Helena/sumstats/munged_noMHC/LEAN04F_noMHC.sumstats.gz
LEAN04M_noMHC	~/Helena/sumstats/munged_noMHC/LEAN04M_noMHC.sumstats.gz
LEAN05_noMHC	~/Helena/sumstats/munged_noMHC/LEAN05_noMHC.sumstats.gz
LEAN05B_noMHC	~/Helena/sumstats/munged_noMHC/LEAN05B_noMHC.sumstats.gz
LEAN05F_noMHC	~/Helena/sumstats/munged_noMHC/LEAN05F_noMHC.sumstats.gz
LEAN05M_noMHC	~/Helena/sumstats/munged_noMHC/LEAN05M_noMHC.sumstats.gz
LEAN06_noMHC	~/Helena/sumstats/munged_noMHC/LEAN06_noMHC.sumstats.gz
LEAN06B_noMHC	~/Helena/sumstats/munged_noMHC/LEAN06B_noMHC.sumstats.gz
LEAN06F_noMHC	~/Helena/sumstats/munged_noMHC/LEAN06F_noMHC.sumstats.gz
LEAN06M_noMHC	~/Helena/sumstats/munged_noMHC/LEAN06M_noMHC.sumstats.gz
LEAN07B_noMHC	~/Helena/sumstats/munged_noMHC/LEAN07B_noMHC.sumstats.gz
LIPI01_noMHC	~/Helena/sumstats/munged_noMHC/LIPI01_noMHC.sumstats.gz
LIPI02_noMHC	~/Helena/sumstats/munged_noMHC/LIPI02_noMHC.sumstats.gz
LIPI03_noMHC	~/Helena/sumstats/munged_noMHC/LIPI03_noMHC.sumstats.gz
LIPI04_noMHC	~/Helena/sumstats/munged_noMHC/LIPI04_noMHC.sumstats.gz
LIPI05_noMHC	~/Helena/sumstats/munged_noMHC/LIPI05_noMHC.sumstats.gz
LIPI06_noMHC	~/Helena/sumstats/munged_noMHC/LIPI06_noMHC.sumstats.gz
LIPI07_noMHC	~/Helena/sumstats/munged_noMHC/LIPI07_noMHC.sumstats.gz
LIPI08_noMHC	~/Helena/sumstats/munged_noMHC/LIPI08_noMHC.sumstats.gz
LIPI09_noMHC	~/Helena/sumstats/munged_noMHC/LIPI09_noMHC.sumstats.gz
LIPI10_noMHC	~/Helena/sumstats/munged_noMHC/LIPI10_noMHC.sumstats.gz
LIPI11_noMHC	~/Helena/sumstats/munged_noMHC/LIPI11_noMHC.sumstats.gz
LIPI12_noMHC	~/Helena/sumstats/munged_noMHC/LIPI12_noMHC.sumstats.gz
LIPI13_noMHC	~/Helena/sumstats/munged_noMHC/LIPI13_noMHC.sumstats.gz
LIPI14_noMHC	~/Helena/sumstats/munged_noMHC/LIPI14_noMHC.sumstats.gz
LIPO01_noMHC	~/Helena/sumstats/munged_noMHC/LIPO01_noMHC.sumstats.gz
LIPO02_noMHC	~/Helena/sumstats/munged_noMHC/LIPO02_noMHC.sumstats.gz
LIPO03_noMHC	~/Helena/sumstats/munged_noMHC/LIPO03_noMHC.sumstats.gz
LIPO04_noMHC	~/Helena/sumstats/munged_noMHC/LIPO04_noMHC.sumstats.gz
LIPO05_noMHC	~/Helena/sumstats/munged_noMHC/LIPO05_noMHC.sumstats.gz
LIPO06_noMHC	~/Helena/sumstats/munged_noMHC/LIPO06_noMHC.sumstats.gz
LIPO07_noMHC	~/Helena/sumstats/munged_noMHC/LIPO07_noMHC.sumstats.gz
LIPO08_noMHC	~/Helena/sumstats/munged_noMHC/LIPO08_noMHC.sumstats.gz
LIPO09_noMHC	~/Helena/sumstats/munged_noMHC/LIPO09_noMHC.sumstats.gz
LIPO10_noMHC	~/Helena/sumstats/munged_noMHC/LIPO10_noMHC.sumstats.gz
LIPO11_noMHC	~/Helena/sumstats/munged_noMHC/LIPO11_noMHC.sumstats.gz
LIPO12_noMHC	~/Helena/sumstats/munged_noMHC/LIPO12_noMHC.sumstats.gz
LIPO13_noMHC	~/Helena/sumstats/munged_noMHC/LIPO13_noMHC.sumstats.gz
LIPO14_noMHC	~/Helena/sumstats/munged_noMHC/LIPO14_noMHC.sumstats.gz
LIPO15_noMHC	~/Helena/sumstats/munged_noMHC/LIPO15_noMHC.sumstats.gz
LIPO16_noMHC	~/Helena/sumstats/munged_noMHC/LIPO16_noMHC.sumstats.gz
LONE01_noMHC	~/Helena/sumstats/munged_noMHC/LONE01_noMHC.sumstats.gz
LONE03_noMHC	~/Helena/sumstats/munged_noMHC/LONE03_noMHC.sumstats.gz
LONG01_noMHC	~/Helena/sumstats/munged_noMHC/LONG01_noMHC.sumstats.gz
LONG02_noMHC	~/Helena/sumstats/munged_noMHC/LONG02_noMHC.sumstats.gz
LONG03_noMHC	~/Helena/sumstats/munged_noMHC/LONG03_noMHC.sumstats.gz
LONG04_noMHC	~/Helena/sumstats/munged_noMHC/LONG04_noMHC.sumstats.gz
LONG05_noMHC	~/Helena/sumstats/munged_noMHC/LONG05_noMHC.sumstats.gz
LONG06_noMHC	~/Helena/sumstats/munged_noMHC/LONG06_noMHC.sumstats.gz
LONG07_noMHC	~/Helena/sumstats/munged_noMHC/LONG07_noMHC.sumstats.gz
LUNG01_noMHC	~/Helena/sumstats/munged_noMHC/LUNG01_noMHC.sumstats.gz
LUNG02_noMHC	~/Helena/sumstats/munged_noMHC/LUNG02_noMHC.sumstats.gz
LUNG03_noMHC	~/Helena/sumstats/munged_noMHC/LUNG03_noMHC.sumstats.gz
LUNG04_noMHC	~/Helena/sumstats/munged_noMHC/LUNG04_noMHC.sumstats.gz
LUNG05_noMHC	~/Helena/sumstats/munged_noMHC/LUNG05_noMHC.sumstats.gz
LUNG06_noMHC	~/Helena/sumstats/munged_noMHC/LUNG06_noMHC.sumstats.gz
LUPU01_noMHC	~/Helena/sumstats/munged_noMHC/LUPU01_noMHC.sumstats.gz
MCLI01_noMHC	~/Helena/sumstats/munged_noMHC/MCLI01_noMHC.sumstats.gz
MEMO01_noMHC	~/Helena/sumstats/munged_noMHC/MEMO01_noMHC.sumstats.gz
MENA01F_noMHC	~/Helena/sumstats/munged_noMHC/MENA01F_noMHC.sumstats.gz
MENA02F_noMHC	~/Helena/sumstats/munged_noMHC/MENA02F_noMHC.sumstats.gz
MENO01F_noMHC	~/Helena/sumstats/munged_noMHC/MENO01F_noMHC.sumstats.gz
MIGR01_noMHC	~/Helena/sumstats/munged_noMHC/MIGR01_noMHC.sumstats.gz
MIGR01F_noMHC	~/Helena/sumstats/munged_noMHC/MIGR01F_noMHC.sumstats.gz
MIGR01M_noMHC	~/Helena/sumstats/munged_noMHC/MIGR01M_noMHC.sumstats.gz
NEUR01_noMHC	~/Helena/sumstats/munged_noMHC/NEUR01_noMHC.sumstats.gz
NEUR02B_noMHC	~/Helena/sumstats/munged_noMHC/NEUR02B_noMHC.sumstats.gz
NEUR02F_noMHC	~/Helena/sumstats/munged_noMHC/NEUR02F_noMHC.sumstats.gz
NEUR02M_noMHC	~/Helena/sumstats/munged_noMHC/NEUR02M_noMHC.sumstats.gz
NEUR03B_noMHC	~/Helena/sumstats/munged_noMHC/NEUR03B_noMHC.sumstats.gz
NEUR03F_noMHC	~/Helena/sumstats/munged_noMHC/NEUR03F_noMHC.sumstats.gz
NEUR03M_noMHC	~/Helena/sumstats/munged_noMHC/NEUR03M_noMHC.sumstats.gz
OBES01_noMHC	~/Helena/sumstats/munged_noMHC/OBES01_noMHC.sumstats.gz
OBES02_noMHC	~/Helena/sumstats/munged_noMHC/OBES02_noMHC.sumstats.gz
OBES03_noMHC	~/Helena/sumstats/munged_noMHC/OBES03_noMHC.sumstats.gz
OBES04_noMHC	~/Helena/sumstats/munged_noMHC/OBES04_noMHC.sumstats.gz
OBES05_noMHC	~/Helena/sumstats/munged_noMHC/OBES05_noMHC.sumstats.gz
OCDI01_noMHC	~/Helena/sumstats/munged_noMHC/OCDI01_noMHC.sumstats.gz
OCDI01F_noMHC	~/Helena/sumstats/munged_noMHC/OCDI01F_noMHC.sumstats.gz
OCDI01M_noMHC	~/Helena/sumstats/munged_noMHC/OCDI01M_noMHC.sumstats.gz
OPEN01_noMHC	~/Helena/sumstats/munged_noMHC/OPEN01_noMHC.sumstats.gz
OSTE01_noMHC	~/Helena/sumstats/munged_noMHC/OSTE01_noMHC.sumstats.gz
OSTE02_noMHC	~/Helena/sumstats/munged_noMHC/OSTE02_noMHC.sumstats.gz
OSTE03_noMHC	~/Helena/sumstats/munged_noMHC/OSTE03_noMHC.sumstats.gz
OSTE04_noMHC	~/Helena/sumstats/munged_noMHC/OSTE04_noMHC.sumstats.gz
OSTE05_noMHC	~/Helena/sumstats/munged_noMHC/OSTE05_noMHC.sumstats.gz
OSTE06_noMHC	~/Helena/sumstats/munged_noMHC/OSTE06_noMHC.sumstats.gz
OSTE07_noMHC	~/Helena/sumstats/munged_noMHC/OSTE07_noMHC.sumstats.gz
OSTE08_noMHC	~/Helena/sumstats/munged_noMHC/OSTE08_noMHC.sumstats.gz
OSTE09_noMHC	~/Helena/sumstats/munged_noMHC/OSTE09_noMHC.sumstats.gz
OSTE10_noMHC	~/Helena/sumstats/munged_noMHC/OSTE10_noMHC.sumstats.gz
OSTE11_noMHC	~/Helena/sumstats/munged_noMHC/OSTE11_noMHC.sumstats.gz
OSTE12_noMHC	~/Helena/sumstats/munged_noMHC/OSTE12_noMHC.sumstats.gz
OSTE13_noMHC	~/Helena/sumstats/munged_noMHC/OSTE13_noMHC.sumstats.gz
OSTE14_noMHC	~/Helena/sumstats/munged_noMHC/OSTE14_noMHC.sumstats.gz
OVER01_noMHC	~/Helena/sumstats/munged_noMHC/OVER01_noMHC.sumstats.gz
PALL01_noMHC	~/Helena/sumstats/munged_noMHC/PALL01_noMHC.sumstats.gz
PHLI01_noMHC	~/Helena/sumstats/munged_noMHC/PHLI01_noMHC.sumstats.gz
PHLI02_noMHC	~/Helena/sumstats/munged_noMHC/PHLI02_noMHC.sumstats.gz
PHLI03_noMHC	~/Helena/sumstats/munged_noMHC/PHLI03_noMHC.sumstats.gz
PHLI04_noMHC	~/Helena/sumstats/munged_noMHC/PHLI04_noMHC.sumstats.gz
PHLI05_noMHC	~/Helena/sumstats/munged_noMHC/PHLI05_noMHC.sumstats.gz
PHLI06_noMHC	~/Helena/sumstats/munged_noMHC/PHLI06_noMHC.sumstats.gz
PHLI07_noMHC	~/Helena/sumstats/munged_noMHC/PHLI07_noMHC.sumstats.gz
PHLI08_noMHC	~/Helena/sumstats/munged_noMHC/PHLI08_noMHC.sumstats.gz
PHLI09_noMHC	~/Helena/sumstats/munged_noMHC/PHLI09_noMHC.sumstats.gz
PHLI10_noMHC	~/Helena/sumstats/munged_noMHC/PHLI10_noMHC.sumstats.gz
PHLI11_noMHC	~/Helena/sumstats/munged_noMHC/PHLI11_noMHC.sumstats.gz
PHLI12_noMHC	~/Helena/sumstats/munged_noMHC/PHLI12_noMHC.sumstats.gz
PHLI13_noMHC	~/Helena/sumstats/munged_noMHC/PHLI13_noMHC.sumstats.gz
PHLI14_noMHC	~/Helena/sumstats/munged_noMHC/PHLI14_noMHC.sumstats.gz
PHYS01_noMHC	~/Helena/sumstats/munged_noMHC/PHYS01_noMHC.sumstats.gz
PHYS01F_noMHC	~/Helena/sumstats/munged_noMHC/PHYS01F_noMHC.sumstats.gz
PHYS01M_noMHC	~/Helena/sumstats/munged_noMHC/PHYS01M_noMHC.sumstats.gz
PRSC01_noMHC	~/Helena/sumstats/munged_noMHC/PRSC01_noMHC.sumstats.gz
PTSD01_noMHC	~/Helena/sumstats/munged_noMHC/PTSD01_noMHC.sumstats.gz
PTSD01F_noMHC	~/Helena/sumstats/munged_noMHC/PTSD01F_noMHC.sumstats.gz
PTSD01M_noMHC	~/Helena/sumstats/munged_noMHC/PTSD01M_noMHC.sumstats.gz
PTSD03_noMHC	~/Helena/sumstats/munged_noMHC/PTSD03_noMHC.sumstats.gz
PTSD03F_noMHC	~/Helena/sumstats/munged_noMHC/PTSD03F_noMHC.sumstats.gz
PTSD03M_noMHC	~/Helena/sumstats/munged_noMHC/PTSD03M_noMHC.sumstats.gz
PUTA01_noMHC	~/Helena/sumstats/munged_noMHC/PUTA01_noMHC.sumstats.gz
REAC01_noMHC	~/Helena/sumstats/munged_noMHC/REAC01_noMHC.sumstats.gz
REAS01_noMHC	~/Helena/sumstats/munged_noMHC/REAS01_noMHC.sumstats.gz
REPR01_noMHC	~/Helena/sumstats/munged_noMHC/REPR01_noMHC.sumstats.gz
REPR01F_noMHC	~/Helena/sumstats/munged_noMHC/REPR01F_noMHC.sumstats.gz
REPR01M_noMHC	~/Helena/sumstats/munged_noMHC/REPR01M_noMHC.sumstats.gz
REPR02_noMHC	~/Helena/sumstats/munged_noMHC/REPR02_noMHC.sumstats.gz
REPR02F_noMHC	~/Helena/sumstats/munged_noMHC/REPR02F_noMHC.sumstats.gz
REPR02M_noMHC	~/Helena/sumstats/munged_noMHC/REPR02M_noMHC.sumstats.gz
RHEU01_noMHC	~/Helena/sumstats/munged_noMHC/RHEU01_noMHC.sumstats.gz
RHEU02_noMHC	~/Helena/sumstats/munged_noMHC/RHEU02_noMHC.sumstats.gz
SCBP01_noMHC	~/Helena/sumstats/munged_noMHC/SCBP01_noMHC.sumstats.gz
SCBP02_noMHC	~/Helena/sumstats/munged_noMHC/SCBP02_noMHC.sumstats.gz
SCHI01_noMHC	~/Helena/sumstats/munged_noMHC/SCHI01_noMHC.sumstats.gz
SCHI02_noMHC	~/Helena/sumstats/munged_noMHC/SCHI02_noMHC.sumstats.gz
SCHI02F_noMHC	~/Helena/sumstats/munged_noMHC/SCHI02F_noMHC.sumstats.gz
SCHI02M_noMHC	~/Helena/sumstats/munged_noMHC/SCHI02M_noMHC.sumstats.gz
SCHI03_noMHC	~/Helena/sumstats/munged_noMHC/SCHI03_noMHC.sumstats.gz
SCLE01_noMHC	~/Helena/sumstats/munged_noMHC/SCLE01_noMHC.sumstats.gz
SCLE02_noMHC	~/Helena/sumstats/munged_noMHC/SCLE02_noMHC.sumstats.gz
SEXH01_noMHC	~/Helena/sumstats/munged_noMHC/SEXH01_noMHC.sumstats.gz
SEXH02_noMHC	~/Helena/sumstats/munged_noMHC/SEXH02_noMHC.sumstats.gz
SEXH03_noMHC	~/Helena/sumstats/munged_noMHC/SEXH03_noMHC.sumstats.gz
SEXH04_noMHC	~/Helena/sumstats/munged_noMHC/SEXH04_noMHC.sumstats.gz
SEXH05_noMHC	~/Helena/sumstats/munged_noMHC/SEXH05_noMHC.sumstats.gz
SEXH06_noMHC	~/Helena/sumstats/munged_noMHC/SEXH06_noMHC.sumstats.gz
SEXH07_noMHC	~/Helena/sumstats/munged_noMHC/SEXH07_noMHC.sumstats.gz
SEXH08_noMHC	~/Helena/sumstats/munged_noMHC/SEXH08_noMHC.sumstats.gz
SEXH09_noMHC	~/Helena/sumstats/munged_noMHC/SEXH09_noMHC.sumstats.gz
SKIN01_noMHC	~/Helena/sumstats/munged_noMHC/SKIN01_noMHC.sumstats.gz
SKIN01F_noMHC	~/Helena/sumstats/munged_noMHC/SKIN01F_noMHC.sumstats.gz
SKIN01M_noMHC	~/Helena/sumstats/munged_noMHC/SKIN01M_noMHC.sumstats.gz
SKIN02_noMHC	~/Helena/sumstats/munged_noMHC/SKIN02_noMHC.sumstats.gz
SKIN02F_noMHC	~/Helena/sumstats/munged_noMHC/SKIN02F_noMHC.sumstats.gz
SKIN02M_noMHC	~/Helena/sumstats/munged_noMHC/SKIN02M_noMHC.sumstats.gz
SKIN03_noMHC	~/Helena/sumstats/munged_noMHC/SKIN03_noMHC.sumstats.gz
SKIN03F_noMHC	~/Helena/sumstats/munged_noMHC/SKIN03F_noMHC.sumstats.gz
SKIN03M_noMHC	~/Helena/sumstats/munged_noMHC/SKIN03M_noMHC.sumstats.gz
SLEE01_noMHC	~/Helena/sumstats/munged_noMHC/SLEE01_noMHC.sumstats.gz
SLEE02_noMHC	~/Helena/sumstats/munged_noMHC/SLEE02_noMHC.sumstats.gz
SMOK01_noMHC	~/Helena/sumstats/munged_noMHC/SMOK01_noMHC.sumstats.gz
SMOK02_noMHC	~/Helena/sumstats/munged_noMHC/SMOK02_noMHC.sumstats.gz
SMOK03_noMHC	~/Helena/sumstats/munged_noMHC/SMOK03_noMHC.sumstats.gz
SMOK04_noMHC	~/Helena/sumstats/munged_noMHC/SMOK04_noMHC.sumstats.gz
SMOK05_noMHC	~/Helena/sumstats/munged_noMHC/SMOK05_noMHC.sumstats.gz
SUBJ01_noMHC	~/Helena/sumstats/munged_noMHC/SUBJ01_noMHC.sumstats.gz
TANN01_noMHC	~/Helena/sumstats/munged_noMHC/TANN01_noMHC.sumstats.gz
TANN01F_noMHC	~/Helena/sumstats/munged_noMHC/TANN01F_noMHC.sumstats.gz
TANN01M_noMHC	~/Helena/sumstats/munged_noMHC/TANN01M_noMHC.sumstats.gz
TEMP01_noMHC	~/Helena/sumstats/munged_noMHC/TEMP01_noMHC.sumstats.gz
TEMP02_noMHC	~/Helena/sumstats/munged_noMHC/TEMP02_noMHC.sumstats.gz
TEMP03_noMHC	~/Helena/sumstats/munged_noMHC/TEMP03_noMHC.sumstats.gz
TEMP04_noMHC	~/Helena/sumstats/munged_noMHC/TEMP04_noMHC.sumstats.gz
THAL01_noMHC	~/Helena/sumstats/munged_noMHC/THAL01_noMHC.sumstats.gz
THIN01_noMHC	~/Helena/sumstats/munged_noMHC/THIN01_noMHC.sumstats.gz
THIN02_noMHC	~/Helena/sumstats/munged_noMHC/THIN02_noMHC.sumstats.gz
TIRE01_noMHC	~/Helena/sumstats/munged_noMHC/TIRE01_noMHC.sumstats.gz
TRGL01_noMHC	~/Helena/sumstats/munged_noMHC/TRGL01_noMHC.sumstats.gz
TRGL02_noMHC	~/Helena/sumstats/munged_noMHC/TRGL02_noMHC.sumstats.gz
TRGL03_noMHC	~/Helena/sumstats/munged_noMHC/TRGL03_noMHC.sumstats.gz
TRGL04_noMHC	~/Helena/sumstats/munged_noMHC/TRGL04_noMHC.sumstats.gz
TRGL05_noMHC	~/Helena/sumstats/munged_noMHC/TRGL05_noMHC.sumstats.gz
TRGL06_noMHC	~/Helena/sumstats/munged_noMHC/TRGL06_noMHC.sumstats.gz
TRGL07_noMHC	~/Helena/sumstats/munged_noMHC/TRGL07_noMHC.sumstats.gz
TRGL08_noMHC	~/Helena/sumstats/munged_noMHC/TRGL08_noMHC.sumstats.gz
TRGL09_noMHC	~/Helena/sumstats/munged_noMHC/TRGL09_noMHC.sumstats.gz
TRGL10_noMHC	~/Helena/sumstats/munged_noMHC/TRGL10_noMHC.sumstats.gz
TRGL11_noMHC	~/Helena/sumstats/munged_noMHC/TRGL11_noMHC.sumstats.gz
TRGL12_noMHC	~/Helena/sumstats/munged_noMHC/TRGL12_noMHC.sumstats.gz
ULCC01_noMHC	~/Helena/sumstats/munged_noMHC/ULCC01_noMHC.sumstats.gz
URAT01_noMHC	~/Helena/sumstats/munged_noMHC/URAT01_noMHC.sumstats.gz
URIN01_noMHC	~/Helena/sumstats/munged_noMHC/URIN01_noMHC.sumstats.gz
URIN02_noMHC	~/Helena/sumstats/munged_noMHC/URIN02_noMHC.sumstats.gz
URIN03_noMHC	~/Helena/sumstats/munged_noMHC/URIN03_noMHC.sumstats.gz
URIN05_noMHC	~/Helena/sumstats/munged_noMHC/URIN05_noMHC.sumstats.gz
URIN07_noMHC	~/Helena/sumstats/munged_noMHC/URIN07_noMHC.sumstats.gz
URIN08_noMHC	~/Helena/sumstats/munged_noMHC/URIN08_noMHC.sumstats.gz
URIN09_noMHC	~/Helena/sumstats/munged_noMHC/URIN09_noMHC.sumstats.gz
URIN11_noMHC	~/Helena/sumstats/munged_noMHC/URIN11_noMHC.sumstats.gz
URIN13_noMHC	~/Helena/sumstats/munged_noMHC/URIN13_noMHC.sumstats.gz
URIN14_noMHC	~/Helena/sumstats/munged_noMHC/URIN14_noMHC.sumstats.gz
URIN15_noMHC	~/Helena/sumstats/munged_noMHC/URIN15_noMHC.sumstats.gz
VITD01_noMHC	~/Helena/sumstats/munged_noMHC/VITD01_noMHC.sumstats.gz
WAIS01_noMHC	~/Helena/sumstats/munged_noMHC/WAIS01_noMHC.sumstats.gz
WAIS01F_noMHC	~/Helena/sumstats/munged_noMHC/WAIS01F_noMHC.sumstats.gz
WAIS01M_noMHC	~/Helena/sumstats/munged_noMHC/WAIS01M_noMHC.sumstats.gz
WAIS02_noMHC	~/Helena/sumstats/munged_noMHC/WAIS02_noMHC.sumstats.gz
WAIS02F_noMHC	~/Helena/sumstats/munged_noMHC/WAIS02F_noMHC.sumstats.gz
WAIS02M_noMHC	~/Helena/sumstats/munged_noMHC/WAIS02M_noMHC.sumstats.gz
WAIS03_noMHC	~/Helena/sumstats/munged_noMHC/WAIS03_noMHC.sumstats.gz
WAIS03F_noMHC	~/Helena/sumstats/munged_noMHC/WAIS03F_noMHC.sumstats.gz
WAIS03M_noMHC	~/Helena/sumstats/munged_noMHC/WAIS03M_noMHC.sumstats.gz
WAIS04_noMHC	~/Helena/sumstats/munged_noMHC/WAIS04_noMHC.sumstats.gz
WAIS04F_noMHC	~/Helena/sumstats/munged_noMHC/WAIS04F_noMHC.sumstats.gz
WAIS04M_noMHC	~/Helena/sumstats/munged_noMHC/WAIS04M_noMHC.sumstats.gz
WEIG01_noMHC	~/Helena/sumstats/munged_noMHC/WEIG01_noMHC.sumstats.gz
WEIG02_noMHC	~/Helena/sumstats/munged_noMHC/WEIG02_noMHC.sumstats.gz
WEIG03_noMHC	~/Helena/sumstats/munged_noMHC/WEIG03_noMHC.sumstats.gz
WEIG04F_noMHC	~/Helena/sumstats/munged_noMHC/WEIG04F_noMHC.sumstats.gz
WEIG04M_noMHC	~/Helena/sumstats/munged_noMHC/WEIG04M_noMHC.sumstats.gz
WEIG05F_noMHC	~/Helena/sumstats/munged_noMHC/WEIG05F_noMHC.sumstats.gz
WHIP01_noMHC	~/Helena/sumstats/munged_noMHC/WHIP01_noMHC.sumstats.gz
WHIP03_noMHC	~/Helena/sumstats/munged_noMHC/WHIP03_noMHC.sumstats.gz
WHIP03F_noMHC	~/Helena/sumstats/munged_noMHC/WHIP03F_noMHC.sumstats.gz
WHIP03M_noMHC	~/Helena/sumstats/munged_noMHC/WHIP03M_noMHC.sumstats.gz
WHIP04_noMHC	~/Helena/sumstats/munged_noMHC/WHIP04_noMHC.sumstats.gz
WHIP04F_noMHC	~/Helena/sumstats/munged_noMHC/WHIP04F_noMHC.sumstats.gz
WHIP04M_noMHC	~/Helena/sumstats/munged_noMHC/WHIP04M_noMHC.sumstats.gz
WHIP05_noMHC	~/Helena/sumstats/munged_noMHC/WHIP05_noMHC.sumstats.gz
WHIP05F_noMHC	~/Helena/sumstats/munged_noMHC/WHIP05F_noMHC.sumstats.gz
WHIP05M_noMHC	~/Helena/sumstats/munged_noMHC/WHIP05M_noMHC.sumstats.gz
WHIP06_noMHC	~/Helena/sumstats/munged_noMHC/WHIP06_noMHC.sumstats.gz
WHIP06F_noMHC	~/Helena/sumstats/munged_noMHC/WHIP06F_noMHC.sumstats.gz
WHIP06M_noMHC	~/Helena/sumstats/munged_noMHC/WHIP06M_noMHC.sumstats.gz
AD_2019	~/CleanSumstats_dir/SUMMARYSTATS/munged_noMHC/AD_2019_noMHC.sumstats.gz
CHARGE_WMH_all	~/CleanSumstats_dir/SUMMARYSTATS/munged_noMHC/CHARGE_WMH_all_noMHC.sumstats.gz
logWMHnorm_stroke	~/CleanSumstats_dir/SUMMARYSTATS/munged_noMHC/logWMHnorm_stroke_noMHC.sumstats.gz
MEGASTROKE_AIS_EUR	~/CleanSumstats_dir/SUMMARYSTATS/munged_noMHC/MEGASTROKE_AIS_EUR_noMHC.sumstats.gz
MEGASTROKE_AIS_TRANS	~/CleanSumstats_dir/SUMMARYSTATS/munged_noMHC/MEGASTROKE_AIS_TRANS_noMHC.sumstats.gz
MEGASTROKE_AS_EUR	~/CleanSumstats_dir/SUMMARYSTATS/munged_noMHC/MEGASTROKE_AS_EUR_noMHC.sumstats.gz
MEGASTROKE_AS_TRANS	~/CleanSumstats_dir/SUMMARYSTATS/munged_noMHC/MEGASTROKE_AS_TRANS_noMHC.sumstats.gz
MEGASTROKE_CES_EUR	~/CleanSumstats_dir/SUMMARYSTATS/munged_noMHC/MEGASTROKE_CES_EUR_noMHC.sumstats.gz
MEGASTROKE_CES_TRANS	~/CleanSumstats_dir/SUMMARYSTATS/munged_noMHC/MEGASTROKE_CES_TRANS_noMHC.sumstats.gz
MEGASTROKE_LAS_EUR	~/CleanSumstats_dir/SUMMARYSTATS/munged_noMHC/MEGASTROKE_LAS_EUR_noMHC.sumstats.gz
MEGASTROKE_LAS_TRANS	~/CleanSumstats_dir/SUMMARYSTATS/munged_noMHC/MEGASTROKE_LAS_TRANS_noMHC.sumstats.gz
MEGASTROKE_SVS_EUR	~/CleanSumstats_dir/SUMMARYSTATS/munged_noMHC/MEGASTROKE_SVS_EUR_noMHC.sumstats.gz
MEGASTROKE_SVS_TRANS	~/CleanSumstats_dir/SUMMARYSTATS/munged_noMHC/MEGASTROKE_SVS_TRANS_noMHC.sumstats.gz
UKB_ICBP_DBP	~/CleanSumstats_dir/SUMMARYSTATS/munged_noMHC/UKB_ICBP_DBP_noMHC.sumstats.gz
UKB_ICBP_PP	~/CleanSumstats_dir/SUMMARYSTATS/munged_noMHC/UKB_ICBP_PP_noMHC.sumstats.gz
UKB_ICBP_SBP	~/CleanSumstats_dir/SUMMARYSTATS/munged_noMHC/UKB_ICBP_SBP_noMHC.sumstats.gz
